.........................
.........................
.. #...#####.............
...###########...........
..############...........
..##############.........
...###############.......
...#############.###.##..
...#############.######..
...#############.######..
....############.#####...
...################......
..###############........
..#############..........
..###########............
....####..##.............
.........................
.........................
